NO ./textures/wall_1.png
SO ./textures/wall_2.png
WE ./textures/wall_3.png
EA ./textures/wall_4.png
P ./textures/barrel.png

F 220,10,10
C 100,30,100





        1111111111111111111111111
        1000000000110000B00000001
        101100000111000000000000111111111111111111111111
        100100B00000000N00000000000000000000000000000001
11111111101100000111000000000000111111111111111111111111
100000000011000001110111110111111
11110111111111011100000010001
11110111111111011101010010B01
11000000110101011100000010001
10000000000000001100000010001
10000000000000001101010010B01
1100000111010101111101111000111
11110111 1110101 101111010001
11111111 1111111 111111111111






